WWWWWWWWWWWWWWWWW
W               W
W    I          W
W  R            W
W               W
W               W
W    R  II      W
W    R          W
W    R   M      W
W    R          W
W      II       W
W      CC       W
W               W
W               W
W               W
W               W
WWWWWWWWWWWWWWWWW