WWWWWW
W    W
W  M W
W    W
WWWWWW