WWWWWWWWWWWWWWWWWWWWWWWWWWWWWWWWW
W                               W
W             I                 W
W          M                    W
W                 I             W
W                               W
W                               W
W                               W
W                               W
W                               W
WWWWWWWWWWWWWWWWWWWWWWWWWWWWWWWWW