WWWWWWWWWWWWWWWWWWWWWWWWWWWWWWWW
W                              W
W             I                W
W                              W
W                 I            W
W                              W
W                              W
W                              W
W                              W
W                              W
W                              W
W                      M       W
W                              W
WWWWWWWWWWWWWWWWWWWWWWWWWWWWWWWW