WWWWWWWWWWWWWWWWW
W               W
W   I           W
W  R     X      W
W  C    M    E  W
W    R  R  R    W
WCRCCRCCCICCCCCCW
WCRCCCCCCCCCCCCCW
WCCCCCCCCCCCCCCCW
WCCCCCCCCCCCCCCCW
WCCCCCCCCCCCCCCCW
WCCCWKKWWWWWKKWWW
WCCCCCCCCCCCCCCCW
WCCCCCX    CCCCCW
WCCCCCECCCCCCCCCW
W               W
W               W
W               W
WWWWWWWWWWWWWWWWW