WWWWWWWWWWWWWWWWW
W               W
W    I          W
W  R            W
W               W
W               W
W    RCCIICCCCCCW
W    RCCCCCCCCCCW
W    RCCCMCCCCCCW
W    RCCCCCCCCCCW
W    CCCIICCCCCCW
W      CC       W
W               W
W               W
W               W
W               W
WWWWWWWWWWWWWWWWW