WWWWWWWWWWWWWWWWWWWWWWWWWWWWWWWWW
WGGGGGGGGGWWGGGGGGGGGWWGGGGGGGGGW
WGGGMGGGGGWWGGGGGGGGGWWGGGGGGGGGW
WGGGGGGGGGWWGGGGGGGGGWWGGGGGGGGGW
WWWWWWWWWWWWGGGGGGGGGWWGGGGGGGGGW
WWWWWWWWWWWWGGMGGGGGGWWGGGGGGGGGW
WGGGGGGGGGWWGGGGGGGGGWWGGGGGGGGGW
WGGGMGGGGGWWGGGGGGGGGWWGGGGGGGGGW
WGGGGGGGGGWWGGGGGGGGGWWGGGGGGGGGW
WWWWWWWWWWWWWWWWWWWWWWWWWWWWWWWWW