WWWWWWWWWWWWWWWWW
W               W
W    I          W
W  R            W
W               W
W               W
W    RCCCICCCCCCW
W    RCCCCCCCCCCW
W    RCCMCCCCCCCW
W    RCCCRCCCCCCW
W    CCCRRRCCCCCW
W   WKKWWWWWKKW W
W               W
W               W
W               W
W               W
W               W
W               W
WWWWWWWWWWWWWWWWW