WWWWWWWWWWWWWWWWWWWWWWWWWWWWWWWWWWWWWWWWWWWWWWWWWWWWWWWWWWWW
WCKRKCKCRRRRRRCCCCCCCCCRRRRRKRRRRRRRRRRRRRCKKKKCCCCCRKCCCCCW
WCKIKCKCCRRRRCCCRRRRIKCCCCCCKRRRRRRRRRRRRKICKKKCRKRCRKRCKKCW
WCKCKCKCCCRRCKKCCCRRRCRRRRRCKRRRRRRRRRRRRKKICKKRCKRCRKCRKCCW
WCK KCKCCCKCCCKKKCRRRKCCCRCCKRRRRRRRRRRRRKKKICKCRKRCRKRCKCKW
WCK KCKKKKKCKCCCKCRRRKCCCRCRKKRRRRRRRRRRKKKKKIKRCKRCRKCRKCCW
WMK KCKCCCRRKKRCKCRRRKKKKKCKKKKRRRRRRRRKKKKKICKCRKRCRKRCKKCW
WCK KCKCRCRRKKRCKCRRRKCCCRCRKKKKRRRRRRRKKKKICKRRCKRCRKCRKCCW
WCK KCCCRCRRKKRCKCRRRKCRCRCRKKKKKRRRRRKKKKICKRCCCKRCRKRCKCRW
WCK KCKRK CCKKRCKCRRRKCRCRCRKKKKKKRRRKKKKICKRCCKKKRCRKCRKCCW
WCC CCKCC CCKKRCKCCCRKCRCRCRKKKKKKKRKKKKICKCCCKRRCCCRKRCKKCW
WKKKKKKKKKKKKKRCKKKCRKCRCCCRKKKKKKKRKKKCCCKCKKRRRCRRRKCRKKCW
WRRRRRRRRRRRRRRCCCKCRKCKKKKKKKKKKKKCKKKKKCCCKCCCCCRRRKCCCKCW
WCCCCCCCCCCCCCCCKCKCRKCRRRRCCCCCCCCCCCCCCKKKKCRRRRRRRKKKCKCW
W KKKKKKKKKKKKKKKCKCRKCRRRRCKCCCCCCCCCCCCKCCCCCCCCCCCCCCCKCW
WCC CCC CC CCCC KCKCRKCCCRRCKCCCCCCCCCCCCKKKKKKKKKKKKKKKKKCW
WCKKKKKKKKKKKKKCKCKCRKKRCRCCKCCCCCCCCCCCCKCCCCCCCCCCCCCCCCCW
W CIC CCC K CIC KCKCRKKKCCCKKCCCCCCCCCCCCKIIICICICICIIICICIW
WCKKKKKKKCKCKKKKKCKCRKKKK KKK            KCICCICICICICICICIW
WCC CCIC CK CCC KCKCRKKK   KK            KCICCIIICICICICIICW
W KKKKKKKCKKKKKCKCKCRK   K  K            KCICCICICICICICICIW
WCC KCC KCK CIKCKKKCRK K  K K            KCICCICICICICICICIW
WCKIC KCC CCKKK CCCCKKK     K            KECCCCCCCCCCCCCCCCW
WWWWWWWWWWWWWWWWWWWWWWWWWWWWWWWWWWWWWWWWWWWWWWWWWWWWWWWWWWWW