WWWWWWWWWWWWWWW
W             W
W             W
W             W
W       R  X  W
W      RRR    W
W      CCC    W
W    E        W
W             W
W             W
W    M KWK    W
W             W
W             W
W             W
WWWWWWWWWWWWWWW