WWWWWWWWWWWWWWWWWWWWWWWWWWWWWWWWWWWWWWWWWWWWWWWWWWWWWWWWWWWW
WKKKKKCKCCECCCCCCCCCCCCCCCCC CCCCCCCCCCCRRRR     RRRRCC    W
W K K K KCCCCCCCCCECCCCCCCCC CCCCCCCCCCCRRRRR   RRRRRCCXXXXW
WX    X KCCCCCCCCCCCCCCCCCCC CCCCCCCCCCCRRRRRR RRRRRRCCK  KW
W KKK K KCCCECCCCCCCCCCECCCC CCCCCCCCCCCRRRRRRRRRRRRRCCKK KW
WKKKKKK KCCCCCCCCCCCCCCCCCCC   XCCCCCCCCRRRRRRRRRRRRRCC KK W
W        CCCCCCCCCECCKCCCCCCCCCCCCCCCCCCRRRRRRRRRRRRRCC   XW
WK K K XKKCCCCCCCCCCCCCCCCCCCCCCCCCCCCCCCCCCCCCCCCCCCCC   XW
KKWWKKWWKKWWKKWWKKWWKKWWKKWWKKWWKKWWKKWWKKWWKKWWKKWWKKWWKKWW
WECCRCCCCCCCRCCCCCCCCCCRCCCCCCCCCCCRCCCRCCCCCCKRCCCCCCCCRCCW
WCCRIICRCCCRRCCRCCCCCRCRCCCCCCICCCICCCCCRCCCRCCCCCCCCRCICCCW
WCCCICCCCICRCCIRCIRCCCCRCCRRCCCCCCRCCCCRRCCRRCICCCRCCCCCCCCW
WCCCCCRRICCCICCRRRRCCCCRCCICCCMCCCCRCCRCIRCCCCCCCRCCCCCRCCCW
WCIRCCCCRRCCRCCRCCCCCCCRCCCCCRCCCCCCRCCCCCCCCICRICCCCRCCCCCW
WCCCCCCCCCCCCCCICCCCCCICCCCCCCCCCCCCCCCCCCCCCCCCCCCCCRCCCCCW
WWWWWWWWWWWWWWWWWWWWWWWWWWWWWWWWWWWWWWWWWWWWWWWWWWWWWWWWWWWW